######################
######################
##..K#.......#....#C##
##.###.###.#.###..#.##
##.....#...#...##.#.##
########.#####......##
#G...#.W.#..K######.##
##.#...###.#..#.#...##
##.#####...#.##.#.####
##.#...##B.#....#...X#
#@.#.#...WW#.###B##.##
####.#######.#.#.C#.##
##.......#.....#.##.##
##.#####.#####.#..#.##
##...#K#.....#.#....##
####.#.#####.#...##.##
##KG.#.#.....###..#.##
##.#.#.###.#.#K####W##
##...#.....#C#....WW##
######################
######################
