#############
########@####
##........C##
##.###.######
##.#C#....C##
##.#.#.###.##
##K#.#.#K#.##
####.#.#.#.##
##...#.#...##
##.#.#.#.#.##
##.#...#.#K##
##X##########
#############
