#############
########@#B##
#G........C##
##.###.######
##.#C#....C##
##.#.#.###.##
##K#.#.#K#.##
####.#.#.#.##
##...#.#...##
##.#.G.#.#.##
##.#...#.#K##
##X##########
#############
