####################
#@##################
#........#.........#
#.######.#.#######.#
#.#....#.#.#....K#.#
#.#.#.##.#.#.###.#.#
###.#....#.#...#.#.#
#K#.######.###.#.#.#
#.#.#K#....#...#.#.#
#.#.#.#.####.#.#.#.#
#.#.#.#.#..#.#.#.#.#
#.#.....#....#.#...#
#.########.#########
#..........#K#.#...#
#.##########...#.#.#
#.#..........#.#.#.#
#.#.##########.#.#.#
#.#......#.....#.#.#
#.######.#.#####.#.#
#........#.......#.#
##################X#
####################