######################
######################
##..K#.......#....#C##
##.###.###.#.###..#.##
##.....#...#...##.#.##
########.#####......##
#G...#...#..K######.##
##.#...###.#..#.#...##
##.#####...#.##.#.####
##.#...##B.#....#...X#
#@.#.#.....#.###B##.##
####.#######.#.#.C#.##
##.......#.....#.##.##
##.#####.#####.#..#.##
##...#K#.....#.#....##
####.#.#####.#...##.##
##KG.#.#.....###..#.##
##.#.#.###.#.#K####.##
##...#.....#C#......##
######################
######################
