#######@###
#.........#
#.###.#####
#.#.#.....#
#.#.#.###.#
#K#.#.#K#.#
###.#.#.#.#
#...#.#...#
#.#.#.#.#.#
#.#...#.#K#
#X#########