########
###@####
##.C#K##
##C##.##
##..C.##
##X#####
########
