##@###
#  #K#
# ## #
#    #
#X####