########
###@####
##.C#K##
#GC##.##
##..C.##
##X#####
########
