######################
##..K#.......#....#.##
##.###.###.#.###..#.##
##.....#...#...##.#.##
########.#####......##
##...#...#..K######.##
##.#...###.#..#.#...##
##.#####...#.##.#.####
##.#...###.#....#...X#
#@.#.#.....#.######.##
####.#######.#.#..#.##
##.......#.....#.##.##
##.#####.#####.#..#.##
##...#K#.....#.#....##
####.#.#####.#...##.##
##K#.#.#.....###..#.##
##.#.#.###.#.#K####.##
##...#.....#.#......##
######################
