######################
######################
##..K#.......#....#C##
##.###.###.#.###..#.##
##.....#...#...##.#.##
########.#####......##
##...#...#..K######.##
##.#...###.#..#.#...##
##.#####...#.##.#.####
##.#...###.#....#...X#
#@.#.#.....#.######.##
####.#######.#.#.C#.##
##.......#.....#.##.##
##.#####.#####.#..#.##
##...#K#.....#.#....##
####.#.#####.#...##.##
##K#.#.#.....###..#.##
##.#.#.###.#.#K####.##
##...#.....#C#......##
######################
######################
