######
##@###
#..#K#
#.##.#
#....#
#X####
######